NO ./xpm/wall_3.xpm
SO ./xpm/crate2_4.xpm
WE ./xpm/crate3_1.xpm
EA ./xpm/crate3_2.xpm
S ./textures/creeper.xpm
F 21,15,14
C 19,84,78

11111111111111111111111111
1111111101110000000000001
1011000001110000001000001
10010000000000000000200111
111111111011000W0111000001111111
1000000000110000011101111111111
11110111111111011100000010001
111101111111110111010100100011
11000000110101011100000010001
100010000000000011000000010001
10000000000000001101010010001
11000001110101011111011110111
111101111110101101111010001
111111111111111111111111111