NO ./path_to_the_north_texture.xpm      
SO ./path_to_the_south_texture.xpm
WE ./path_to_the_west_texture.xpm
EA ./path_to_the_east_texture.xpm
S ./textures/creeper.xpm
F 220,100,0
C 225,30,0

11111111111111111111111111
1111111101110000000000001
10110W0001110000002000001
100100000000000000000200111
11111111101100000111000001111111
1000000000110000011101111111111
11110111111111011100000010001
111101111111110111010100100011
11000000110101011100000010001
100020000000000011000000010001
10000000000000001101010010001
11000001110101011111011110111
111101111110101101111010001
111111111111111111111111111