NO ./xpm/wall_3.xpm
SO ./xpm/crate2_4.xpm
WE ./xpm/crate3_1.xpm
EA ./xpm/crate3_2.xpm
F 21,15,146
C 19,84,78


        1111111111111111111111111
        1000000000000000000000001
        101100000W000000000000001
        1001000000000000000000001
111111111011000000000000000000001111111
10000000000000000000000000001111
10000000000000000000000000001
100000000000000000000000000011
100000000000000000000000000011
100000000000000000000000000011
100000000000000000000000000011
10000000000000000000000000001
10000000000000000000000000001
10000000000000000000000000001
11000001110101011111011110011
11110111111101011101111010001
1111111111111111111111111111