NO ./xpm/wall_3.xpm
SO ./xpm/crate2_4.xpm
WE ./xpm/crate3_1.xpm
EA ./xpm/crate3_2.xpm
F 21,15,146
C 19,84,78

        1111111111111111111111111
        1000000000000000000000001
        1011000000000000000000001
        10010000000000000000000011
11111111101100000000000000000000111111111111
1000000000000000000000000000111111
10000000000000000000000000001
100000000000000000000000000011
100000000000000S000000000000011
100000000000000000000000000011
100000000000000000000000000011
100000000000000000000000000011
10000000000000000000000000001
100000000000000000000000000011
11000001110101011111011110011
11110111111110011101111010001
1111111111111111111111111111