
NO textures/wall_3.xpm
SO textures/wall_3.xpm
WE textures/wall_3.xpm
EA textures/wall_3.xpm
S textures/lion.xpm
F 184,113,39
C 51,198,227

   1111111111111111111111111111
  11000000001100000000000000001
  10010000011100000111100010001
  100100000000000201  100010001
1110110000011100000111100010001
1000000000000000000000000000011
100000000011000001111111111111
111101100011110111
   1011001111101 11111111111
1111000011010101110000000001
1000000000000000110000001011
10200000000000001101010010011
111101111001010000200000W0001
10000000001111100000000000111
111000000001  1000010100011
  1111111111  111111111111

